................................
................................
................................
................................
..........#######...............
..........##..###...............
..........#..$..######..........
..........#..#..#..+.#..........
..........#..#@.#....#..........
..........#..#..#+$$.#..........
..........##.#...+.###..........
..........#.....#+.#............
..........##$#$##+.#............
..........#........#............
..........#....##..#............
..........##########............
................................
................................


