................................
................................
................................
................................
................................
................................
............#########...........
............#...@...#...........
............#.......#...........
............#.......#...........
............#.......#...........
............####!####...........
............####?####...........
............#########...........
............#########...........
................................
................................
................................

