................................
................................
................................
...................###..........
............########@#####......
............#...........##......
.........####$####$##$#$##......
.........#..$....$.......#......
.........##..#...$.......#......
.........###+#$##+########......
.........###+++.#.#.............
.........#..+++.#.#.............
.........#.######.#.............
.........#........#.............
.........##########.............
................................
................................
................................