................................
................................
.........###############........
.........#......##+....#........
.........#....+@..++.#.#........
.........#.##$#..#..$..#........
.........#.$..#$####$###........
.........#..$.#..$..$..#........
.........##$..++.#.$...#........
.........##.#+#.*++#.$.#........
.........#..#+#$+#+##+##........
.........#.$..#....##+.#........
.........#..###$.$###..#........
.........#...$++$..++$.#........
.........##..#.....#####........
.........###############........
................................
................................