................................
................................
................................
................................
.........########...............
.........#...#@.#...............
.........#...#..#...............
.........#...#+.#...............
.........##.....#...............
.........#..##+.#...............
.........#.$$.#.#...............
.........#..#...#...............
.........########...............
................................
................................
................................
................................