................................
...#####........................           
...#...#........................
#####.#.####....................
#+++#.$....##...................
#++......$..#####...............
#+..#.#$##$.....#...............
###...#.@#...##.####............
##   $ $#$#  #.....#............
#  #   $     ..###.#............
#  #$#  $ #  ###+# #............
#    #### #  #+++  #............
##               # #............
.############### # #............
...............#   #............
...............#####............
................................
................................