################
#..............#
#..............#
#.....$........#
#..............#
#..+...........#
#..............#
#......@.......#
#..............#
#..............#
#..............#
################
