................................
................................
................................
..........#######...............
..........##..###...............
..........#..$..######..........
..........#..#..#..+.#..........
..........#..#@.#....#..........
..........#..#..#+$$.#..........
..........##.#...+.###..........
..........##....#+.#............
..........##$#$##+.#............
..........#........#............
..........#...###..#............
..........##########............
................................
................................
................................
