################################
#.............####.............#
#..............................#
#....######.............######.#
#..............................#
#......$.....$.................#
#......$.............$.........#
#..####...........####.........#
#..............................#
#...@..........................#
#..####...........####.........#
#..............................#
#...........++++...............#
#....######.............######.#
#..............................#
#.............####.............#
#..............................#
################################
