................................
...........#####................
..........#...#.................
..........#.#.##########........
........####.#..#...#...#.......
........#.......#.$...$#####....
........#.##.#$.#...#...#...#...
........#.$..#..##.##.$...$#....
........#..##.#####..#...#...#..
........#.$...#..#..######.##...
........###.$....@.+++.#.#.#....
.........#...#.....+++#.#.#.....
.........#####..###+++#.#.###...
.............####.#####.#...#...
..................#.$.#.........
..................#...#.........
..................#####.........