................................
................................
................................
................................
..........############..........
..........#.+....+.+.#..........
..........#+#...#.$#+#..........
..........#.$...#$.+.#..........
..........#$#......#$#..........
..........#.+$...$$+.#..........
..........#.#.....@#.#..........
..........############..........
................................
................................
................................
................................
................................
................................


