................................
................................
................................
.........######.................
.........#+.++####..............
.........#.+.....##.............
.......###.#.#....##............
.......#.........#$.#...........
.......#....#..###..#...........
.......#.#..#..##...#...........
.......#.@..#..#.$..#...........
.......#....#..$...##...........
.......#..#####...##............
.......#......$..##.............
.......#..########..............
.......####.....................
................................
................................