................................
................................
.....#############..............
.....#...........#..............
.....#.$########.#..............
.....#....$..###.#....####......
.....##$###..###.#####++##......
.....##.###..###.#....+++#......
.....#..##..$..$......++##......
.....#..##...###.#####++##......
.....#..###$####.#....####......
.....##$###...##.#..............
.....#....$...$..#..............
.....#...##..@####..............
.....#############..............
................................
................................
................................