................................
................................
................................
..........##############........
..........#...#........#........
..........#.$.$.$.$..$.#........
..........#.#$#.###..$.#........
..........#.#.+++++##$##........
..........#..++++++..$.#........
.......#####$#@++++#.#.#........
.......#.....####.#.$$.#........
.......#..$#....$$.$.#.#........
.......#..$.++#........#........
.......#################........
................................
................................
................................
................................