................................
................................
................................
................................
...........##########...........
...........#@#......#...........
...........#...$#...#...........
...........#$#...#..#...........
...........#.....#$.#...........
...........#...#.#..#...........
...........#.#...##.#...........
...........#.#......#...........
...........#+.....++#...........
...........##########...........
................................
................................
................................
................................

