................................
................................
................................
.......#########................
.......#....#..####.............
.......#.#.+$++.+.######........
.......#.$..#.+.#++....#........
.......##$#$#########..#........
.......#.$..##.....##..#........
.......#...#.$.#.#..#+##........
.......##+.@.$..$#$.#+.#........
.......#######...$.....#........
..............######...#........
....................####........
................................
................................
................................
................................