................................
................................
................................
................................
..........###########...........
..........#+..#@#..+#...........
..........#+..$.$..+#...........
..........#+#######+#...........
..........#+...#...+#...........
..........#.$$.*.$$.#...........
..........#...$#$...#...........
...........##..#..##............
............#######.............
................................
................................
................................
................................
................................